000M00000000mm00mM00000mm0m00000000000m000000000m0000M00000000M00000000m0000m0000000m000000Mm0m00000
0I0I0I0I0I0I0IMI0I0ImI0I0I0I0I0I0I0ImI0I0I0I0I0I0I0I0I0I0I0I0I0I0I0ImI0I0I0IMI0I0I0I0I0I0I0ImI0I0I0I
000000000000M000M00000m0000000MMM0M0M00m0000mm0M00m0000000000000M000000m000M000M0M00000MMM0000000m00
mI0I0I0I0I0ImI0I0I0IMIMI0I0I0I0I0I0I0I0I0ImI0I0I0I0I0I0I0I0I0I0I0I0I0I0I0I0I0I0I0I0I0I0I0I0I0I0I0I0I
0M0000M000000M00m0mM00000000m000000m00M00000000000MM0000000m0M000M00mM00000000m00m0M00000M00M0m0000m
0I0I0I0IMI0I0ImI0IMI0I0I0I0I0I0I0I0I0IMI0IMI0ImI0I0I0IMI0I0I0I0I0IMI0I0IMI0I0I0I0I0I0I0I0ImI0I0I0I0I
m00M0M000000000mM00M00000000M00000000m0M0m0000000M000000000000m0Mm0M00mm0M00mmM0000000000000M0000M00
0I0I0IMI0I0I0I0I0I0I0I0I0I0I0IMImI0I0I0I0I0I0I0I0I0I0IMI0I0I0IMI0ImI0I0I0I0IMI0I0IMI0I0ImI0I0I0I0IMI
0m0M0000m0000000M00M00m0000m00M00MM0M0m00000MM0000000000000m000000000m00m000m00000000000000M00m00000
0I0IMI0I0I0I0I0I0ImI0I0I0I0IMIMI0I0I0I0I0I0I0I0I0IMI0I0I0I0IMI0I0I0I0I0I0IMIMI0I0I0I0I0I0IMI0I0I0I0I
000M000M000m00000000M00M0mm00000M0M000000M00000000000000000m000000000m0M0000000m0000000m00000M000000
0I0I0IMI0I0I0I0I0I0I0I0ImI0I0I0I0I0I0I0I0I0IMI0I0I0I0I0I0ImI0I0I0I0IMI0I0I0IMI0ImI0I0I0I0ImI0I0ImI0I
000000000m00000000m00m000000m0000M0000000000000000m00000m00000000000000000m00m00000000M0000m00M00m0m
0IMIMI0I0I0I0m000M000M0000000000M00000000000M00mmM0m00M000M0000M00m00000000m0000000000000I0I0I0ImI0I
0000M0000000M0000m000M000m00000000000M00mm0M000000000000m000m00MM000mMM00000000000000mm000000000M000
0ImI0I0I0ImIMm000000000m000m000000000m00m000000000000000000000000000000000000000m00000000I0I0I0I0I0I
m0M0m00000m0000m00000M000000M000000000000m0000000000000mM0000000m0000000000000000000m0M0M000000m0000
0I0I0I0I0I0I000000M0m00000m000Mm00m000000m000mmm00000000000000m0Mm0000000M00M00000000M000I0IMI0ImI0I
m000M000m00000000000000M0000000m00m0000M000000M00000M00m00M00m000000M000M0m00m0MM000000m00M00m00M00m
0I0I0ImI0I0I0000000000000M000000000000m0000mm000000M000000M0000000mm000M000M00000M0000m00I0I0I0I0I0I
00000000000000000mm0000000000000000m0000000m0000000000000m00M0M000M000000mM0000000M0000000m00000M00M
0I0IMI0IMI0I00000000M00m000M0M000000M000000000Mm000M000mm00M000000000000000000000000Mm00mI0I0I0ImI0I
0m0000Mm00mmM00000M0000000M000000mM0000m0000m00000M0000M0000m00MM00000M00M000m000000m00000000MMm00mM
0I0ImI0I0I0IM000M00000M00M00000M000000000000000MM000M0000000Mm000M00M000000m0000000000000I0ImI0I0ImI
0m000M000mM00000M000M00M00000m0000M0000000mM0m0mM0m000000m00m0M00000M000m000000000000m00M0000000Mm0M
0I0I0I0I0I0I00m000000M0m000m000M000000000m000000000000000M0M00MM000mM000000000000M0000000I0I0I0I0I0I
00000m0mM0000000000mm00000000M000M000M0000M0000m00m00M00M000m0000000000M00000000m0000m000000m000M000
mI0I0I0I0I0I000000000000000M000000000m00000M00000000000MM000M0000000m00000m000000M0000000I0I0I0ImI0I
0M0M00000000mm000m0M000000000m0000000000M0000m0000000000000000m000000m00000m0m0M00M000000000M0000000
0I0I0I0IMI0I00000000000mM0000M000000000000mmM0MM0000M000m00MM0000000mMm000000000000000000I0I0ImI0I0I
00000000M00000000m00m00M00000mMm0M0M000000000000000000MM00m00M00MM00000m000m0mM00000m000000000Mm0000
mImImI0I0I0I00000000000000m000M0000Mm00000000m000m000000000m000m000mm0m0000m00M0Mm00000m0I0ImI0I0IMI
mMM000000000000000000000000000000000M000M0000000000000m0000000m00000000M000000000000000M00000M000000
0I0I0I0ImIMIm000m00M0000m0000000Mm00m000000000000000M0000000M0000000M000000000000m00000M0I0I0I0I0I0I
000M0000m00000000000M0m0000000000M0000MMm00M00000000000m00MM0000M00m000m000000mM0M000000000MM0M0000m
0I0ImI0I0I0I00000000M0000000000000000000000m00000000000M00000000m0000m00m00m000000Mmm0m00I0I0I0IMI0I
000000M0000m0000000000000M0M0000m0000M0000m00000m0000000M00M00000000000m000M000M00000M00000000000000
0I0I0I0I0I0I0000000000m00000000000m00000000000000mmM00m0mm0000000M0mM0000000M000m00000m00I0I0I0I0I0I
000000M0M000M00000m0000000m000m000M0000000000000000m000000m000m0000M000m0000000000000M00000m00000000
0I0ImImI0I0Im0000000000M0m00M00000M000000000M000m000m000m00m00m000MmM000000000m0000000000I0ImI0I0I0I
m0000000m00000m0000000000000mmM000000000000m000000m0m000m00MM000000M000m000m000M00000000m00000m00000
0I0I0I0I0I0I000m000000000000000M000m000000m00M00000000000m00MM000m0M00000M0M0000000000M00IMI0I0I0IMI
00000mm0000000m000000M00000m0000000M0000000m00m0000M000000M000000000000m000m000000000000m0M000000000
mI0IMI0I0I0I000000000m0m00000000000M000m00000M0000000m00m00000000000000m00m0000000000000MI0I0I0I0I0I
000m00m000000000000000000000m000m0000000m000000000mM0000m00M0m000mM00000M0M0Mm000m000000000m000mm0m0
mI0I0I0I0I0I0M000m000M000000000000000000000Mm00000000000000M000000mm0M00000000m000M000000I0I0I0I0I0I
m0m000000m0000000m0000M0000MM0000M0Mm00Mm000000000000M000000000000000M000000000000000000M00000000000
mI0I0I0ImI0Im000m00000M0000000000mm00000m0000M0000M0m000000m0M000MM000000000000000M000m00I0I0I0I0ImI
0000MMm00M0000000mmM0000000000mMm00000000M000000MM000000m0m00m000000000m000000000M000m000M000M0mM0m0
0I0I0I0I0ImIM000M0m000m00m000Mm00M00M0M000M0M0m0000m0MM00M0000M000000000M000M000M00000000I0I0ImI0I0I
000000000000M0mmmmM000000m000000M0000m00000000000000000000000000M00000m0M00M000000m0000000m000000M00
0I0I0I0I0I0I0Mm00000M00000m00M0M000mM0000000m000M0mm0000mM00M0000m000000000M0000M000000MMIMImI0I0I0I
0000000000000000m000mmm0m0MM0000000000000000000M00000M00M00000000000m000000M000m0000000000MM00000000
0I0ImI0I0I0I000m00M000000000000m0000m00000M0m000M0000000000000m00M00mm0mMm0000M0000000000I0I0I0I0I0I
00000000000000000m0000m00000000000000m00M00Mm00000mm0000000m0m0000000000000M0m0000m0M00000m0m0m0000m
MI0I0I0I0I0IM00m000000m00m0000000M00000000000M0M0M0mm00000000m00mm0M0M000000000m000000000I0I0I0I0IMI
M000000M000000000000MMmMM00000000m0000Mm00Mm00000m00m000000M00000000000000000m0m000m0m000M0000000000
0I0I0I0IMImI0000M0M00MM00000000m000000M00M000000000000m000MM000M00M00000M00000000Mm000m00I0I0ImI0I0I
00000m00mMm0m0000M0m0000000000000M0000mM00000m00m000000000MM0000M00000000000000000M000m0M00000000000
MImI0I0I0I0I00000000000000m000MM000mM0000m0000000000000Mm00mmm00000M0000M0M00M00M0m0000M0I0I0IMI0I0I
0000m0m0000000000000MM00m0000000m000000m00M000000m0000000000M0000000000000M0000mm0000M000M0000000000
0I0ImI0I0I0I000000000M000000000m000000000000m00m00000M0000MM000M0M0M0000m0000000m00000M00I0I0IMI0I0I
000m00000000m0000000000m00Mm0MM00M0000000m000000M0000M000m00000000M00M00m00000000MM00m0m000000000000
0I0I0IMI0I0I00Mm0000000000M00m00000000m0000M00M0000mmM00mM00000M00m00000000M000M000MM0000I0ImI0I0I0I
000Mm0000m00000000M000000M00000000000000M00m0000000000000000M000m000M000000m000000M0000m00000000M00M
0I0I0IMI0I0I00000000MMM000000M0m000mMMm00M00000000000000M000000m000M0000000m00M0000mM00MMIMI0I0ImI0I
M00000000000m000000mm0M00000000000000M00000m00m000000000000m0m000000m000000m000000000000M00000000000
MI0I0I0I0I0I0M00M00M0000000m00000000000000000000000000000000m000000000000000000M000M00000ImI0I0IMIMI
0000000000000000m00M00000mM000000000000000m00000000000000000000m000M00000000000000m0m00000mm000m0000
0I0I0ImImI0Im00M000000000M0000000m000Mm00m000000MM000mM0m000M00000000000000M0M000000000M0IMI0I0I0ImI
00m0000000000000m000000mM0000000000000000000000m00000000000000mm000m000000000mM0000000m000000000M000
mI0I0I0I0I0I000000m00000m000000m00m000000000000m000m0000000000000000000000M00000000000000I0IMI0I0I0I
0000000Mmm0000000000000m0000000000000000000000000000m00000000M000000000m0000000M000000mm00000m000000
0IMImI0I0I0I00M00m00m00M00000000000M0000000000m0000000000000m0mM00M000m00000000M0000m0M00IMI0I0ImI0I
0000000000000m00000m00M000M00m000000M0m00000M0MM0000000m00000M0000m0000000M0M0000m00000000000m0000M0
0I0I0I0I0I0I0M00MM0M00M0m0m00000m00000000Mm000000000Mm000m00000000000m0000m000m00000m0000I0I0I0I0ImI
000000m0mM00m00000000000000m0m000M000MM000000000m0000000m000000M000000000000m00m0mM0M00M000000M00000
0I0I0I0I0IMI0000M0000000M000000MM00000M000000m000mm00000000000000000M00000000000000m00000I0I0I0I0I0I
000000000M00000000mm0m0000000000m00000mM000000000000000000M00000000000mm000M00000000m000000m0M0000MM
0I0I0I0I0I0I0000m000000000000000000000M00000000MMM000000000mmm000000m00m00M000000M0000M00ImI0I0IMIMI
0000000000000000m00000MM000000000M0000m000M00M0M0000m00MMmM000000mM000mM000000000000000M00000m000m00
0I0I0I0I0I0I00M00000m000mM00000M0m000MM0000m000000000000M000M0000M0000m00M00000000M00000mI0I0I0I0I0I
0m000000000000M0000000m0000000m00mm000000000000000m000m0mMMm000M0M00000m0000m00000000000M00000M000M0
MImI0ImI0I0I000000000MM0m0000000m0M000m000000000000000m0000000000000000000000000000000000I0I0I0I0I0I
m00m000000M0000m0Mm0MM0000000000000M00M0000M00000M00Mm0000m0M0000000m00000Mm0000000mM000000000000000
0IMIMI0I0I0I00M0m000000mMm0000mm00000M00M000m0m0000000mm00000000m000m0000M00m0mM000m00000I0IMIMI0IMI
00000m00000M000m0000000000000MMM0000m0000M000mm00m000000000000M000000000MM000000000M0000000000m00000
0I0I0I0I0I0I000000000M0000000M00000000000m0000m0000M000000MM00mMM000M0000M000M000000000M0I0IMI0IMI0I
000000000000000000m00000M000m0M000M00m00000m00000000000M000M0M000000000000000000M0m0000000000000mm00
0I0IMI0I0I0I0I0I0I0I0I0I0ImI0IMI0I0I0I0I0I0I0I0I0I0I0I0I0IMImI0I0IMI0I0I0I0I0I0I0I0I0I0I0I0I0I0I0I0I
0000000m000000000M0000000000m00000m00000M000MM00000000Mm000000000M00000000000m0000000M00000000M000M0
0I0I0I0I0I0I0I0I0I0IMI0I0I0I0I0ImI0I0I0I0ImI0I0I0I0I0I0I0I0I0I0I0I0ImIMI0ImImI0I0I0I0I0I0I0I0I0I0I0I
0000000000000M000000000MmM0000000000mM0000MMm0000000m0000Mm000m0000000M000M00000000mm000mM000000M000
0I0I0I0I0I0I0IMI0I0I0I0I0I0I0I0I0IMI0I0I0I0I0I0I0I0I0IMIMI0I0I0I0I0I0I0I0ImI0I0I0ImI0I0IMI0IMI0I0I0I
0000000mm00000m00000000000m00M00m0m0000M000000M000M00MM000m00M000M00000M000000mM00M00M0m00m00000m000
0I0I0I0I0I0I0I0I0I0I0I0I0I0I0I0I0I0ImI0I0IMI0I0I0ImIMI0I0I0I0I0ImI0I0I0IMI0I0I0I0I0I0I0I0I0I0IMIMI0I
m000m0000m00m000M00000000000M0mM00000000m000000M000MM0000m000000000000MmM000000000000m00000000m000M0
mImI0I0I0I0I0I0I0I0I0I0ImImI0I0I0ImI0I0IMI0I0I0I0I0I0I0I0I0I0I0IMI0I0IMI0I0I0I0I0I0I0I0I0IMI0I0I0I0I
00000M000000000000m0000000000000m00000M000000M000M000000000m000Mm0000M000000mm0000000M0m00000000m0M0
MI0I0IMI0I0I0I0I0I0I0I0I0I0ImI0ImI0I0I0I0I0I0I0I0I0I0I0I0IMI0IMI0I0I0I0I0I0IMI0I0I0I0I0ImI0I0I0I0I0I
